------------------------------------------------------------
------------------------------------------------------------
------------------------------------------------------------
------------------------------------------------------------
--------------------------522222222226----------------------
--------------------------1-----T----1----------------------
--------------------------1----------1----------------------
--------------------------1----------1----------------------
--------------------------1----------1----------------------
--------------------------1----------1----------------------
--------------------------1----------1T---------------------
-----------------T522222224----------322222226--------------
------------------1--------------------------1--------------
------------------1--------------------------1--------------
------------------1--------------------------1--------------
------------------1--------------------------1--------------
------------------1--------------------------1T-------------
S222222222222222227T-------------------------822222222222E--
------------------1--------------------------1--------------
------------------1--------------------------1--------------
------------------1--------------------------1--------------
------------------1--------------------------1--------------
------------------1--------------------------1T-------------
-----------------T322222226----------522222224--------------
--------------------------1----------1----------------------
--------------------------1----------1----------------------
--------------------------1----------1----------------------
--------------------------1----------1----------------------
--------------------------1-----T----1----------------------
--------------------------322222222224----------------------
------------------------------------------------------------
------------------------------------------------------------
------------------------------------------------------------
------------------------------------------------------------
------------------------------------------------------------
------------------------------------------------------------
------------------------------------------------------------