------------------------------------------------------------
------------------------------------------------------------
------------------------------------------------------------
------------------------------------------------------------
--------------------------------T------T--------------------
-----------------------5222222222222222222226---------------
-----------------------1--------------------1---------------
-----------------------1--------------------1---------------
----------------------T1-------------------T1---------------
-----------------------1--------------------1---------------
S2222222222226---------1--------------------1---------------
------------T1---------H22222C--------------1---------------
-------------1-----------T---1--------------1---------------
-------------1---------------1--------------1---------------
-------------1T-------------T1--------------1---------------
-------------32222222912222224--------------1---------------
---------------------1T---------------------1T--------------
---------------------1----------------------8222222222222E--
---------------------1----------------------1---------------
---------------------1----------------------1---------------
-------------522222229----------------------1---------------
------------T1------T1----------------------1---------------
-------------1-------1----------------------1---------------
-------------1-------1----------------------1---------------
-------------1-------322222222222226--------1---------------
-------------1-------------T-------1--------1T--------------
------------T1---------------------1--------1---------------
S2222222222224---------------------1T-------1---------------
-----------------------------------1--------1---------------
-----------------------------------3222222224---------------
--------------------------------------T---------------------
------------------------------------------------------------
------------------------------------------------------------
------------------------------------------------------------
------------------------------------------------------------
------------------------------------------------------------
------------------------------------------------------------